00000000000000000000
00000000000000000000
00000000000000000000
00000000000000000000
22200000000000000000
10000000000000000000
10000000022222000010
10000000000000000010
1000000000000000010
10000000000000000010
01111111111111111110
00000000000000000000