00000000000000000000
00000000000000000000
00000000000000000000
00000000000000000000
11100000000000000000
10000000000000000000
10000000011111000010
10000000000000000010
1000000000000000010
10000000000000000010
01111111111111111110
00000000000000000000